25 11 11 11 11 11 11 11 11 11 11 11 11 11 11 26 11 11 11 11 11 24
25 12 12 12 12 12 12 12 12 12 12 12 12 12 12 27 12 12 12 12 12 24
25 13 13 13 13 13 13 13 13 13 13 13 13 13 13 28 13 13 13 13 13 24
25 10 10 10 10 10 10 10 10 10 10 10 10 10 10 23 10 10 10 10 10 24
25 10 10 10 10 10 10 10 10 10 10 10 10 10 10 23 10 10 10 10 10 24
25 10 10 10 10 10 10 10 10 10 10 10 10 10 10 23 10 10 10 10 10 24
25 10 10 10 10 10 10 10 10 10 10 10 10 10 10 23 10 10 10 10 10 24
25 10 10 10 10 10 10 10 10 10 10 10 10 10 10 11 11 10 10 11 11 24
25 11 11 10 10 11 11 23 10 10 10 10 10 10 10 12 12 10 10 12 12 24
25 12 12 10 10 12 12 23 10 10 10 10 10 10 10 13 13 10 10 13 13 24
25 13 13 10 10 13 13 23 10 10 10 10 10 10 10 10 10 10 10 10 10 24
25 10 10 10 10 10 10 23 10 10 10 10 10 10 10 10 10 10 10 10 10 24
25 10 10 10 10 10 10 23 10 10 10 10 10 10 10 10 10 10 10 10 10 24
25 10 10 10 10 10 10 23 10 10 10 10 10 10 10 10 10 10 10 10 10 24
25 10 10 10 10 10 10 23 10 10 10 10 10 10 10 10 10 10 10 10 10 24
22 20 20 20 20 20 20 20 20 20 20 20 20 20 20 20 20 20 20 20 20