17 3 3 3 3 3 3 3 3 3 3 3 3 3 3 18 3 3 3 3 3 16
17 4 4 4 4 4 4 4 4 4 4 4 4 4 4 19 4 4 4 4 4 16
17 5 5 5 5 5 5 5 5 5 5 5 5 5 5 20 5 5 5 5 5 16
17 2 2 2 2 2 2 2 2 2 2 2 2 2 2 15 2 2 2 2 2 16
17 2 2 2 2 2 2 2 2 2 2 2 2 2 2 15 2 2 2 2 2 16
17 2 2 2 2 2 2 2 2 2 2 2 2 2 2 15 2 2 2 2 2 16
17 2 2 2 2 2 2 2 2 2 2 2 2 2 2 15 2 2 2 2 2 16
17 2 2 2 2 2 2 2 2 2 2 2 2 2 2 3 3 3 3 3 3 16
17 3 3 3 3 3 3 15 2 2 2 2 2 2 2 4 4 4 4 4 4 16
17 4 4 4 4 4 4 15 2 2 2 2 2 2 2 5 5 5 5 5 5 16
17 5 5 5 5 5 5 15 2 2 2 2 2 2 2 2 2 2 2 2 2 16
17 2 2 2 2 2 2 15 2 2 2 2 2 2 2 2 2 2 2 2 2 16
17 2 2 2 2 2 2 15 2 2 2 2 2 2 2 2 2 2 2 2 2 16
17 2 2 2 2 2 2 15 2 2 2 2 2 2 2 2 2 2 2 2 2 16
17 2 2 2 2 2 2 15 2 2 2 2 2 2 2 2 2 2 2 2 2 16
14 12 12 12 12 12 12 12 12 12 12 12 12 12 12 12 12 12 12 12 12

